10
15
15

xxxxxxxxxx...xx
x.....xxx.....x
x..xxxxxxxx...x
x.............x
x...xx....xx..x
x.........xxxxx
xxxxxxxxx.....x
x........xxx..x
x.............x
xx...xxxxxxxxxx
x...xx........x
x...xx...x...xx
x........xx...x
xxxx...xxxx...x
xxxx...xxxxxxxx