10
20
15

xxxxxxxxxxxxxxxxxx.x
x..................x
x...xxxx....xxxx...x
x....xx......xx....x
x........xx........x
x........xx........x
x........xx........x
x..........x.......x
x...........x......x
x........xxx.......x
x..................x
x...xx........xx...x
x.....xxxxxxxx.....x
x..................x
x.xxxxxxxxxxxxxxxxxx